22 86
   _________________________________________________________________________________
  |                         |                            |                          |
  |                         |    JOAQUÍN VILUMBRALES     |  EXIT   ---->            |
  |_________________________|____________________________|__________________________|
  |                                                                                 |
  |                                                                                 |
  |                                                                                 |
  |____________     _____________________    ______________________     ____________|
  |____________     _____________________    ______________________     ____________|
  |                                                                                 |
  |                                                                                 |
  |                                                                                 |
  |                                                                                 |
  |                                                                                 |
  |_________________________________________________________________________________|
  |_________________________________________________________________________________|
  |                                                                                 |
  |                                                                                 |
  |                                                                                 |
  |                                                                                 |
  |                                                                                 |
  |_________________________________________________________________________________|
